System.AccessViolationException	TRUE
System.AppDomainManager	TRUE
System.AppDomainSetup	TRUE
System.AppDomainUnloadedException	TRUE
System.ApplicationException	TRUE
System.ArgumentException	TRUE
System.ArgumentNullException	TRUE
System.ArgumentOutOfRangeException	TRUE
System.ArithmeticException	TRUE
System.ArrayTypeMismatchException	TRUE
System.BadImageFormatException	TRUE
System.CannotUnloadAppDomainException	TRUE
System.ContextMarshalException	TRUE
System.ContextStaticAttribute	TRUE
System.DataMisalignedException	TRUE
System.DivideByZeroException	TRUE
System.DllNotFoundException	TRUE
System.DuplicateWaitObjectException	TRUE
System.EntryPointNotFoundException	TRUE
System.EventArgs	TRUE
System.Exception	TRUE
System.ExecutionEngineException	TRUE
System.FieldAccessException	TRUE
System.FlagsAttribute	TRUE
System.FormatException	TRUE
System.IndexOutOfRangeException	TRUE
System.InvalidCastException	TRUE
System.InvalidOperationException	TRUE
System.InvalidProgramException	TRUE
System.MemberAccessException	TRUE
System.MethodAccessException	TRUE
System.MissingFieldException	TRUE
System.MissingMemberException	TRUE
System.MissingMethodException	TRUE
System.MTAThreadAttribute	TRUE
System.MulticastNotSupportedException	TRUE
System.NonSerializedAttribute	TRUE
System.NotFiniteNumberException	TRUE
System.NotImplementedException	TRUE
System.NotSupportedException	TRUE
System.NullReferenceException	TRUE
System.Object	TRUE
System.ObsoleteAttribute	TRUE
System.OperationCanceledException	TRUE
System.OutOfMemoryException	TRUE
System.OverflowException	TRUE
System.ParamArrayAttribute	TRUE
System.PlatformNotSupportedException	TRUE
System.Random	TRUE
System.RankException	TRUE
System.SerializableAttribute	TRUE
System.StackOverflowException	TRUE
System.STAThreadAttribute	TRUE
System.SystemException	TRUE
System.ThreadStaticAttribute	TRUE
System.TimeoutException	TRUE
System.TypeLoadException	TRUE
System.TypeUnloadedException	TRUE
System.UnauthorizedAccessException	TRUE
System.Version	TRUE
System.Collections.ArrayList	TRUE
System.Collections.CaseInsensitiveComparer	TRUE
System.Collections.CaseInsensitiveHashCodeProvider	TRUE
System.Collections.Hashtable	TRUE
System.Collections.Queue	TRUE
System.Collections.SortedList	TRUE
System.Collections.Stack	TRUE
System.Collections.Generic.KeyNotFoundException	TRUE
System.Globalization.DateTimeFormatInfo	TRUE
System.Globalization.GregorianCalendar	TRUE
System.Globalization.HebrewCalendar	TRUE
System.Globalization.HijriCalendar	TRUE
System.Globalization.JapaneseCalendar	TRUE
System.Globalization.JulianCalendar	TRUE
System.Globalization.KoreanCalendar	TRUE
System.Globalization.NumberFormatInfo	TRUE
System.Globalization.StringInfo	TRUE
System.Globalization.TaiwanCalendar	TRUE
System.Globalization.ThaiBuddhistCalendar	TRUE
System.IO.DirectoryNotFoundException	TRUE
System.IO.DriveNotFoundException	TRUE
System.IO.EndOfStreamException	TRUE
System.IO.FileLoadException	TRUE
System.IO.FileNotFoundException	TRUE
System.IO.IOException	TRUE
System.IO.MemoryStream	TRUE
System.IO.PathTooLongException	TRUE
System.IO.StringWriter	TRUE
System.Security.AllowPartiallyTrustedCallersAttribute	TRUE
System.Security.HostProtectionException	TRUE
System.Security.HostSecurityManager	TRUE
System.Security.SecurityException	TRUE
System.Security.SuppressUnmanagedCodeSecurityAttribute	TRUE
System.Security.UnverifiableCodeAttribute	TRUE
System.Security.VerificationException	TRUE
System.Security.XmlSyntaxException	TRUE
System.Security.Cryptography.CryptoConfig	TRUE
System.Security.Cryptography.CryptographicException	TRUE
System.Security.Cryptography.CryptographicUnexpectedOperationException	TRUE
System.Security.Cryptography.CspParameters	TRUE
System.Security.Cryptography.DESCryptoServiceProvider	TRUE
System.Security.Cryptography.DSACryptoServiceProvider	TRUE
System.Security.Cryptography.DSASignatureDeformatter	TRUE
System.Security.Cryptography.DSASignatureFormatter	TRUE
System.Security.Cryptography.FromBase64Transform	TRUE
System.Security.Cryptography.HMACMD5	TRUE
System.Security.Cryptography.HMACRIPEMD160	TRUE
System.Security.Cryptography.HMACSHA1	TRUE
System.Security.Cryptography.HMACSHA256	TRUE
System.Security.Cryptography.HMACSHA384	TRUE
System.Security.Cryptography.HMACSHA512	TRUE
System.Security.Cryptography.MACTripleDES	TRUE
System.Security.Cryptography.MD5CryptoServiceProvider	TRUE
System.Security.Cryptography.PKCS1MaskGenerationMethod	TRUE
System.Security.Cryptography.RC2CryptoServiceProvider	TRUE
System.Security.Cryptography.RijndaelManaged	TRUE
System.Security.Cryptography.RIPEMD160Managed	TRUE
System.Security.Cryptography.RNGCryptoServiceProvider	TRUE
System.Security.Cryptography.RSACryptoServiceProvider	TRUE
System.Security.Cryptography.RSAOAEPKeyExchangeDeformatter	TRUE
System.Security.Cryptography.RSAOAEPKeyExchangeFormatter	TRUE
System.Security.Cryptography.RSAPKCS1KeyExchangeDeformatter	TRUE
System.Security.Cryptography.RSAPKCS1KeyExchangeFormatter	TRUE
System.Security.Cryptography.RSAPKCS1SignatureDeformatter	TRUE
System.Security.Cryptography.RSAPKCS1SignatureFormatter	TRUE
System.Security.Cryptography.SHA1CryptoServiceProvider	TRUE
System.Security.Cryptography.SHA1Managed	TRUE
System.Security.Cryptography.SHA256Managed	TRUE
System.Security.Cryptography.SHA384Managed	TRUE
System.Security.Cryptography.SHA512Managed	TRUE
System.Security.Cryptography.SignatureDescription	TRUE
System.Security.Cryptography.ToBase64Transform	TRUE
System.Security.Cryptography.TripleDESCryptoServiceProvider	TRUE
System.Text.ASCIIEncoding	TRUE
System.Text.StringBuilder	TRUE
System.Text.UnicodeEncoding	TRUE
System.Text.UTF7Encoding	TRUE
System.Text.UTF8Encoding	TRUE
System.Threading.Mutex	TRUE
System.Threading.Overlapped	TRUE
System.Threading.ReaderWriterLock	TRUE
System.Threading.SynchronizationLockException	TRUE
System.Threading.ThreadInterruptedException	TRUE
System.Threading.ThreadStateException	TRUE
Microsoft.JScript.COMFieldInfo	TRUE
Microsoft.JScript.COMMethodInfo	TRUE
Microsoft.JScript.COMPropertyInfo	TRUE
Microsoft.JScript.DebugConvert	TRUE
Microsoft.JScript.JSAuthor	TRUE
System.ActivationContext	FALSE
System.Activator	FALSE
System.TimeZoneInfo.AdjustmentRule	FALSE
System.AggregateException	FALSE
System.AppContext	FALSE
System.AppDomain	FALSE
System.ApplicationId	FALSE
System.ApplicationIdentity	FALSE
System.Array	FALSE
System.AssemblyLoadEventArgs	FALSE
System.Attribute	FALSE
System.AttributeUsageAttribute	FALSE
System.BitConverter	FALSE
System.Buffer	FALSE
System.CharEnumerator	FALSE
System.CLSCompliantAttribute	FALSE
System.Console	FALSE
System.ConsoleCancelEventArgs	FALSE
System.ContextBoundObject	FALSE
System.Convert	FALSE
System.DBNull	FALSE
System.Delegate	FALSE
System.Enum	FALSE
System.Environment	FALSE
System.FileStyleUriParser	FALSE
System.FormattableString	FALSE
System.FtpStyleUriParser	FALSE
System.GC	FALSE
System.GenericUriParser	FALSE
System.GopherStyleUriParser	FALSE
System.HttpStyleUriParser	FALSE
System.InsufficientExecutionStackException	FALSE
System.InsufficientMemoryException	FALSE
System.InvalidTimeZoneException	FALSE
System.Lazy	FALSE
System.Lazy	FALSE
System.LdapStyleUriParser	FALSE
System.LoaderOptimizationAttribute	FALSE
System.LocalDataStoreSlot	FALSE
System.MarshalByRefObject	FALSE
System.Math	FALSE
System.MulticastDelegate	FALSE
System.NetPipeStyleUriParser	FALSE
System.NetTcpStyleUriParser	FALSE
System.NewsStyleUriParser	FALSE
System.Nullable	FALSE
System.ObjectDisposedException	FALSE
System.OperatingSystem	FALSE
System.Progress	FALSE
System.ResolveEventArgs	FALSE
System.String	FALSE
System.StringComparer	FALSE
System.TimeZone	FALSE
System.TimeZoneInfo	FALSE
System.TimeZoneNotFoundException	FALSE
System.Tuple	FALSE
System.Tuple	FALSE
System.Tuple	FALSE
System.Tuple	FALSE
System.Tuple	FALSE
System.Tuple	FALSE
System.Tuple	FALSE
System.Tuple	FALSE
System.Tuple	FALSE
System.TupleExtensions	FALSE
System.Type	FALSE
System.TypeAccessException	FALSE
System.TypeInitializationException	FALSE
System.UnhandledExceptionEventArgs	FALSE
System.Uri	FALSE
System.UriBuilder	FALSE
System.UriFormatException	FALSE
System.UriParser	FALSE
System.UriTemplate	FALSE
System.UriTemplateEquivalenceComparer	FALSE
System.UriTemplateMatch	FALSE
System.UriTemplateMatchException	FALSE
System.UriTemplateTable	FALSE
System.UriTypeConverter	FALSE
System.ValueType	FALSE
System.WeakReference	FALSE
System.WeakReference	FALSE
System.Collections.BitArray	FALSE
System.Collections.CollectionBase	FALSE
System.Collections.Comparer	FALSE
System.Collections.DictionaryBase	FALSE
System.Collections.ReadOnlyCollectionBase	FALSE
System.Collections.StructuralComparisons	FALSE
System.Collections.Generic.Comparer	FALSE
System.Collections.Generic.Dictionary	FALSE
System.Collections.Generic.EqualityComparer	FALSE
System.Collections.Generic.HashSet	FALSE
System.Collections.Generic.Dictionary.KeyCollection	FALSE
System.Collections.Generic.SortedDictionary.KeyCollection	FALSE
System.Collections.Generic.KeyedByTypeCollection	FALSE
System.Collections.Generic.LinkedList	FALSE
System.Collections.Generic.LinkedListNode	FALSE
System.Collections.Generic.List	FALSE
System.Collections.Generic.Queue	FALSE
System.Collections.Generic.SortedDictionary	FALSE
System.Collections.Generic.SortedList	FALSE
System.Collections.Generic.SortedSet	FALSE
System.Collections.Generic.Stack	FALSE
System.Collections.Generic.SynchronizedCollection	FALSE
System.Collections.Generic.SynchronizedKeyedCollection	FALSE
System.Collections.Generic.SynchronizedReadOnlyCollection	FALSE
System.Collections.Generic.Dictionary.ValueCollection	FALSE
System.Collections.Generic.SortedDictionary.ValueCollection	FALSE
System.Device.Location.CivicAddress	FALSE
System.Device.Location.CivicAddressResolver	FALSE
System.Device.Location.GeoCoordinate	FALSE
System.Device.Location.GeoCoordinateWatcher	FALSE
System.Device.Location.GeoPosition	FALSE
System.Device.Location.GeoPositionChangedEventArgs	FALSE
System.Device.Location.GeoPositionStatusChangedEventArgs	FALSE
System.Device.Location.ResolveAddressCompletedEventArgs	FALSE
System.Drawing.Bitmap	FALSE
System.Drawing.BitmapSuffixInSameAssemblyAttribute	FALSE
System.Drawing.BitmapSuffixInSatelliteAssemblyAttribute	FALSE
System.Drawing.Brush	FALSE
System.Drawing.Brushes	FALSE
System.Drawing.BufferedGraphics	FALSE
System.Drawing.BufferedGraphicsContext	FALSE
System.Drawing.BufferedGraphicsManager	FALSE
System.Drawing.ColorConverter	FALSE
System.Drawing.ColorTranslator	FALSE
System.Drawing.Font	FALSE
System.Drawing.FontConverter	FALSE
System.Drawing.FontFamily	FALSE
System.Drawing.FontConverter.FontNameConverter	FALSE
System.Drawing.FontConverter.FontUnitConverter	FALSE
System.Drawing.Graphics	FALSE
System.Drawing.Icon	FALSE
System.Drawing.IconConverter	FALSE
System.Drawing.Image	FALSE
System.Drawing.ImageAnimator	FALSE
System.Drawing.ImageConverter	FALSE
System.Drawing.ImageFormatConverter	FALSE
System.Drawing.Pen	FALSE
System.Drawing.Pens	FALSE
System.Drawing.PointConverter	FALSE
System.Drawing.RectangleConverter	FALSE
System.Drawing.Region	FALSE
System.Drawing.SizeConverter	FALSE
System.Drawing.SizeFConverter	FALSE
System.Drawing.SolidBrush	FALSE
System.Drawing.StringFormat	FALSE
System.Drawing.SystemBrushes	FALSE
System.Drawing.SystemColors	FALSE
System.Drawing.SystemFonts	FALSE
System.Drawing.SystemIcons	FALSE
System.Drawing.SystemPens	FALSE
System.Drawing.TextureBrush	FALSE
System.Drawing.ToolboxBitmapAttribute	FALSE
System.Drawing.Imaging.BitmapData	FALSE
System.Drawing.Imaging.ColorMap	FALSE
System.Drawing.Imaging.ColorMatrix	FALSE
System.Drawing.Imaging.ColorPalette	FALSE
System.Drawing.Imaging.Encoder	FALSE
System.Drawing.Imaging.EncoderParameter	FALSE
System.Drawing.Imaging.EncoderParameters	FALSE
System.Drawing.Imaging.FrameDimension	FALSE
System.Drawing.Imaging.ImageAttributes	FALSE
System.Drawing.Imaging.ImageCodecInfo	FALSE
System.Drawing.Imaging.ImageFormat	FALSE
System.Drawing.Imaging.Metafile	FALSE
System.Drawing.Imaging.MetafileHeader	FALSE
System.Drawing.Imaging.MetaHeader	FALSE
System.Drawing.Imaging.PropertyItem	FALSE
System.Drawing.Imaging.WmfPlaceableFileHeader	FALSE
System.Drawing.Printing.InvalidPrinterException	FALSE
System.Drawing.Printing.Margins	FALSE
System.Drawing.Printing.MarginsConverter	FALSE
System.Drawing.Printing.PageSettings	FALSE
System.Drawing.Printing.PaperSize	FALSE
System.Drawing.Printing.PrinterSettings.PaperSizeCollection	FALSE
System.Drawing.Printing.PaperSource	FALSE
System.Drawing.Printing.PrinterSettings.PaperSourceCollection	FALSE
System.Drawing.Printing.PreviewPageInfo	FALSE
System.Drawing.Printing.PreviewPrintController	FALSE
System.Drawing.Printing.PrintController	FALSE
System.Drawing.Printing.PrintDocument	FALSE
System.Drawing.Printing.PrinterResolution	FALSE
System.Drawing.Printing.PrinterSettings.PrinterResolutionCollection	FALSE
System.Drawing.Printing.PrinterSettings	FALSE
System.Drawing.Printing.PrinterUnitConvert	FALSE
System.Drawing.Printing.PrintEventArgs	FALSE
System.Drawing.Printing.PrintingPermission	FALSE
System.Drawing.Printing.PrintingPermissionAttribute	FALSE
System.Drawing.Printing.PrintPageEventArgs	FALSE
System.Drawing.Printing.QueryPageSettingsEventArgs	FALSE
System.Drawing.Printing.StandardPrintController	FALSE
System.Drawing.Printing.PrinterSettings.StringCollection	FALSE
System.Globalization.Calendar	FALSE
System.Globalization.CharUnicodeInfo	FALSE
System.Globalization.ChineseLunisolarCalendar	FALSE
System.Globalization.CompareInfo	FALSE
System.Globalization.CultureAndRegionInfoBuilder	FALSE
System.Globalization.CultureInfo	FALSE
System.Globalization.CultureNotFoundException	FALSE
System.Globalization.DaylightTime	FALSE
System.Globalization.EastAsianLunisolarCalendar	FALSE
System.Globalization.IdnMapping	FALSE
System.Globalization.JapaneseLunisolarCalendar	FALSE
System.Globalization.KoreanLunisolarCalendar	FALSE
System.Globalization.PersianCalendar	FALSE
System.Globalization.RegionInfo	FALSE
System.Globalization.SortKey	FALSE
System.Globalization.SortVersion	FALSE
System.Globalization.TaiwanLunisolarCalendar	FALSE
System.Globalization.TextElementEnumerator	FALSE
System.Globalization.TextInfo	FALSE
System.Globalization.UmAlQuraCalendar	FALSE
System_CAPS_pubclass.BinaryReader	FALSE
System.IO.BinaryWriter	FALSE
System.IO.BufferedStream	FALSE
System.IO.Directory	FALSE
System.IO.DirectoryInfo	FALSE
System.IO.DriveInfo	FALSE
System.IO.ErrorEventArgs	FALSE
System.IO.File	FALSE
System.IO.FileFormatException	FALSE
System.IO.FileInfo	FALSE
System.IO.FileStream	FALSE
System.IO.FileSystemEventArgs	FALSE
System.IO.FileSystemInfo	FALSE
System.IO.FileSystemWatcher	FALSE
System.IO.InternalBufferOverflowException	FALSE
System.IO.InvalidDataException	FALSE
System.IO.IODescriptionAttribute	FALSE
System.IO.Path	FALSE
System.IO.PipeException	FALSE
System.IO.RenamedEventArgs	FALSE
System.IO.Stream	FALSE
System.IO.StreamReader	FALSE
System.IO.StreamWriter	FALSE
System.IO.StringReader	FALSE
System.IO.TextReader	FALSE
System.IO.TextWriter	FALSE
System.IO.UnmanagedMemoryAccessor	FALSE
System.IO.UnmanagedMemoryStream	FALSE
System.IO.Compression.DeflateStream	FALSE
System.IO.Compression.GZipStream	FALSE
System.IO.Compression.ZipArchive	FALSE
System.IO.Compression.ZipArchiveEntry	FALSE
System.IO.Compression.ZipFile	FALSE
System.IO.Compression.ZipFileExtensions	FALSE
System.IO.Packaging.EncryptedPackageEnvelope	FALSE
System.IO.Packaging.Package	FALSE
System.IO.Packaging.PackageDigitalSignature	FALSE
System.IO.Packaging.PackageDigitalSignatureManager	FALSE
System.IO.Packaging.PackagePart	FALSE
System.IO.Packaging.PackagePartCollection	FALSE
System.IO.Packaging.PackageProperties	FALSE
System.IO.Packaging.PackageRelationship	FALSE
System.IO.Packaging.PackageRelationshipCollection	FALSE
System.IO.Packaging.PackageRelationshipSelector	FALSE
System.IO.Packaging.PackageStore	FALSE
System.IO.Packaging.PackUriHelper	FALSE
System.IO.Packaging.PackWebRequest	FALSE
System.IO.Packaging.PackWebRequestFactory	FALSE
System.IO.Packaging.PackWebResponse	FALSE
System.IO.Packaging.RightsManagementInformation	FALSE
System.IO.Packaging.SignatureVerificationEventArgs	FALSE
System.IO.Packaging.StorageInfo	FALSE
System.IO.Packaging.StreamInfo	FALSE
System.IO.Packaging.ZipPackage	FALSE
System.IO.Packaging.ZipPackagePart	FALSE
System.Media.SoundPlayer	FALSE
System.Media.SystemSound	FALSE
System.Media.SystemSounds	FALSE
System.Net.AuthenticationManager	FALSE
System.Net.Authorization	FALSE
System.Net.Cookie	FALSE
System.Net.CookieCollection	FALSE
System.Net.CookieContainer	FALSE
System.Net.CookieException	FALSE
System.Net.CredentialCache	FALSE
System.Net.Dns	FALSE
System.Net.DnsEndPoint	FALSE
System.Net.DnsPermission	FALSE
System.Net.DnsPermissionAttribute	FALSE
System.Net.DownloadDataCompletedEventArgs	FALSE
System.Net.DownloadProgressChangedEventArgs	FALSE
System.Net.DownloadStringCompletedEventArgs	FALSE
System.Net.EndPoint	FALSE
System.Net.EndpointPermission	FALSE
System.Net.WebRequestMethods.File	FALSE
System.Net.FileWebRequest	FALSE
System.Net.FileWebResponse	FALSE
System.Net.WebRequestMethods.Ftp	FALSE
System.Net.FtpWebRequest	FALSE
System.Net.FtpWebResponse	FALSE
System.Net.GlobalProxySelection	FALSE
System.Net.WebRequestMethods.Http	FALSE
System.Net.HttpListener	FALSE
System.Net.HttpListenerBasicIdentity	FALSE
System.Net.HttpListenerContext	FALSE
System.Net.HttpListenerException	FALSE
System.Net.HttpListenerPrefixCollection	FALSE
System.Net.HttpListenerRequest	FALSE
System.Net.HttpListenerResponse	FALSE
System.Net.HttpListenerTimeoutManager	FALSE
System.Net.HttpVersion	FALSE
System.Net.HttpWebRequest	FALSE
System.Net.HttpWebResponse	FALSE
System.Net.IPAddress	FALSE
System.Net.IPEndPoint	FALSE
System.Net.IPEndPointCollection	FALSE
System.Net.IPHostEntry	FALSE
System.Net.NetworkCredential	FALSE
System.Net.NetworkProgressChangedEventArgs	FALSE
System.Net.OpenReadCompletedEventArgs	FALSE
System.Net.OpenWriteCompletedEventArgs	FALSE
System.Net.ProtocolViolationException	FALSE
System.Net.ServicePoint	FALSE
System.Net.ServicePointManager	FALSE
System.Net.SocketAddress	FALSE
System.Net.SocketPermission	FALSE
System.Net.SocketPermissionAttribute	FALSE
System.Net.TransportContext	FALSE
System.Net.UiSynchronizationContext	FALSE
System.Net.UploadDataCompletedEventArgs	FALSE
System.Net.UploadFileCompletedEventArgs	FALSE
System.Net.UploadProgressChangedEventArgs	FALSE
System.Net.UploadStringCompletedEventArgs	FALSE
System.Net.UploadValuesCompletedEventArgs	FALSE
System.Net.WebClient	FALSE
System.Net.WebException	FALSE
System.Net.WebHeaderCollection	FALSE
System.Net.WebPermission	FALSE
System.Net.WebPermissionAttribute	FALSE
System.Net.WebProxy	FALSE
System.Net.WebRequest	FALSE
System.Net.WebRequestMethods	FALSE
System.Net.WebResponse	FALSE
System.Net.WebUtility	FALSE
System.Net.WriteStreamClosedEventArgs	FALSE
System.Net.Http.ByteArrayContent	FALSE
System.Net.Http.DelegatingHandler	FALSE
System.Net.Http.FormUrlEncodedContent	FALSE
System.Net.Http.HttpClient	FALSE
System.Net.Http.HttpClientHandler	FALSE
System.Net.Http.HttpContent	FALSE
System.Net.Http.HttpMessageHandler	FALSE
System.Net.Http.HttpMessageInvoker	FALSE
System.Net.Http.HttpMethod	FALSE
System.Net.Http.HttpRequestException	FALSE
System.Net.Http.HttpRequestMessage	FALSE
System.Net.Http.HttpResponseMessage	FALSE
System.Net.Http.MessageProcessingHandler	FALSE
System.Net.Http.MultipartContent	FALSE
System.Net.Http.MultipartFormDataContent	FALSE
System.Net.Http.StreamContent	FALSE
System.Net.Http.StringContent	FALSE
System.Net.Http.WebRequestHandler	FALSE
System.Net.Mail.AlternateView	FALSE
System.Net.Mail.AlternateViewCollection	FALSE
System.Net.Mail.Attachment	FALSE
System.Net.Mail.AttachmentBase	FALSE
System.Net.Mail.AttachmentCollection	FALSE
System.Net.Mail.LinkedResource	FALSE
System.Net.Mail.LinkedResourceCollection	FALSE
System.Net.Mail.MailAddress	FALSE
System.Net.Mail.MailAddressCollection	FALSE
System.Net.Mail.MailMessage	FALSE
System.Net.Mail.SmtpClient	FALSE
System.Net.Mail.SmtpException	FALSE
System.Net.Mail.SmtpFailedRecipientException	FALSE
System.Net.Mail.SmtpFailedRecipientsException	FALSE
System.Net.Mail.SmtpPermission	FALSE
System.Net.Mail.SmtpPermissionAttribute	FALSE
System.Net.Sockets.HttpPolicyDownloaderProtocol	FALSE
System.Net.Sockets.IPv6MulticastOption	FALSE
System.Net.Sockets.LingerOption	FALSE
System.Net.Sockets.MulticastOption	FALSE
System.Net.Sockets.NetworkStream	FALSE
System.Net.Sockets.SendPacketsElement	FALSE
System.Net.Sockets.Socket	FALSE
System.Net.Sockets.SocketAsyncEventArgs	FALSE
System.Net.Sockets.SocketException	FALSE
System.Net.Sockets.SocketPolicy	FALSE
System.Net.Sockets.TcpClient	FALSE
System.Net.Sockets.TcpListener	FALSE
System.Net.Sockets.UdpAnySourceMulticastClient	FALSE
System.Net.Sockets.UdpClient	FALSE
System.Net.Sockets.UdpSingleSourceMulticastClient	FALSE
System.Printing.LocalPrintServer	FALSE
System.Printing.PageImageableArea	FALSE
System.Printing.PageMediaSize	FALSE
System.Printing.PageResolution	FALSE
System.Printing.PageScalingFactorRange	FALSE
System.Printing.PrintCapabilities	FALSE
System.Printing.PrintCommitAttributesException	FALSE
System.Printing.PrintDocumentImageableArea	FALSE
System.Printing.PrintDriver	FALSE
System.Printing.PrintFilter	FALSE
System.Printing.PrintingCanceledException	FALSE
System.Printing.PrintingNotSupportedException	FALSE
System.Printing.PrintJobException	FALSE
System.Printing.PrintJobInfoCollection	FALSE
System.Printing.PrintJobSettings	FALSE
System.Printing.PrintPort	FALSE
System.Printing.PrintProcessor	FALSE
System.Printing.PrintQueue	FALSE
System.Printing.PrintQueueCollection	FALSE
System.Printing.PrintQueueException	FALSE
System.Printing.PrintQueueStream	FALSE
System.Printing.PrintQueueStringProperty	FALSE
System.Printing.PrintServer	FALSE
System.Printing.PrintServerException	FALSE
System.Printing.PrintSystemException	FALSE
System.Printing.PrintSystemJobInfo	FALSE
System.Printing.PrintSystemObject	FALSE
System.Printing.PrintSystemObjectPropertiesChangedEventArgs	FALSE
System.Printing.PrintSystemObjectPropertyChangedEventArgs	FALSE
System.Printing.PrintSystemObjects	FALSE
System.Printing.PrintTicket	FALSE
System.Security.CodeAccessPermission	FALSE
System.Security.NamedPermissionSet	FALSE
System.Security.PermissionSet	FALSE
System.Security.ReadOnlyPermissionSet	FALSE
System.Security.SecureString	FALSE
System.Security.SecurityContext	FALSE
System.Security.SecurityCriticalAttribute	FALSE
System.Security.SecurityElement	FALSE
System.Security.SecurityManager	FALSE
System.Security.SecurityRulesAttribute	FALSE
System.Security.SecuritySafeCriticalAttribute	FALSE
System.Security.SecurityState	FALSE
System.Security.SecurityTransparentAttribute	FALSE
System.Security.SecurityTreatAsSafeAttribute	FALSE
System.Security.Cryptography.Aes	FALSE
System.Security.Cryptography.AesCng	FALSE
System.Security.Cryptography.AesCryptoServiceProvider	FALSE
System.Security.Cryptography.AesManaged	FALSE
System.Security.Cryptography.AsnEncodedData	FALSE
System.Security.Cryptography.AsnEncodedDataCollection	FALSE
System.Security.Cryptography.AsnEncodedDataEnumerator	FALSE
System.Security.Cryptography.AsymmetricAlgorithm	FALSE
System.Security.Cryptography.AsymmetricKeyExchangeDeformatter	FALSE
System.Security.Cryptography.AsymmetricKeyExchangeFormatter	FALSE
System.Security.Cryptography.AsymmetricSignatureDeformatter	FALSE
System.Security.Cryptography.AsymmetricSignatureFormatter	FALSE
System.Security.Cryptography.CngAlgorithm	FALSE
System.Security.Cryptography.CngAlgorithmGroup	FALSE
System.Security.Cryptography.CngKey	FALSE
System.Security.Cryptography.CngKeyBlobFormat	FALSE
System.Security.Cryptography.CngKeyCreationParameters	FALSE
System.Security.Cryptography.CngPropertyCollection	FALSE
System.Security.Cryptography.CngProvider	FALSE
System.Security.Cryptography.CngUIPolicy	FALSE
System.Security.Cryptography.CryptoAPITransform	FALSE
System.Security.Cryptography.CryptographicAttributeObject	FALSE
System.Security.Cryptography.CryptographicAttributeObjectCollection	FALSE
System.Security.Cryptography.CryptographicAttributeObjectEnumerator	FALSE
System.Security.Cryptography.CryptoStream	FALSE
System.Security.Cryptography.CspKeyContainerInfo	FALSE
System.Security.Cryptography.DataProtector	FALSE
System.Security.Cryptography.DeriveBytes	FALSE
System.Security.Cryptography.DES	FALSE
System.Security.Cryptography.DpapiDataProtector	FALSE
System.Security.Cryptography.DSA	FALSE
System.Security.Cryptography.DSACng	FALSE
System.Security.Cryptography.ECDiffieHellman	FALSE
System.Security.Cryptography.ECDiffieHellmanCng	FALSE
System.Security.Cryptography.ECDiffieHellmanCngPublicKey	FALSE
System.Security.Cryptography.ECDiffieHellmanPublicKey	FALSE
System.Security.Cryptography.ECDsa	FALSE
System.Security.Cryptography.ECDsaCng	FALSE
System.Security.Cryptography.HashAlgorithm	FALSE
System.Security.Cryptography.HMAC	FALSE
System.Security.Cryptography.KeyedHashAlgorithm	FALSE
System.Security.Cryptography.KeySizes	FALSE
System.Security.Cryptography.ManifestSignatureInformation	FALSE
System.Security.Cryptography.ManifestSignatureInformationCollection	FALSE
System.Security.Cryptography.MaskGenerationMethod	FALSE
System.Security.Cryptography.MD5	FALSE
System.Security.Cryptography.MD5Cng	FALSE
System.Security.Cryptography.ECCurve.NamedCurves	FALSE
System.Security.Cryptography.Oid	FALSE
System.Security.Cryptography.OidCollection	FALSE
System.Security.Cryptography.OidEnumerator	FALSE
System.Security.Cryptography.PasswordDeriveBytes	FALSE
System.Security.Cryptography.ProtectedData	FALSE
System.Security.Cryptography.ProtectedMemory	FALSE
System.Security.Cryptography.RandomNumberGenerator	FALSE
System.Security.Cryptography.RC2	FALSE
System.Security.Cryptography.Rfc2898DeriveBytes	FALSE
System.Security.Cryptography.Rijndael	FALSE
System.Security.Cryptography.RijndaelManagedTransform	FALSE
System.Security.Cryptography.RIPEMD160	FALSE
System.Security.Cryptography.RSA	FALSE
System.Security.Cryptography.RSACng	FALSE
System.Security.Cryptography.RSAEncryptionPadding	FALSE
System.Security.Cryptography.RSASignaturePadding	FALSE
System.Security.Cryptography.SHA1	FALSE
System.Security.Cryptography.SHA1Cng	FALSE
System.Security.Cryptography.SHA256	FALSE
System.Security.Cryptography.SHA256Cng	FALSE
System.Security.Cryptography.SHA256CryptoServiceProvider	FALSE
System.Security.Cryptography.SHA384	FALSE
System.Security.Cryptography.SHA384Cng	FALSE
System.Security.Cryptography.SHA384CryptoServiceProvider	FALSE
System.Security.Cryptography.SHA512	FALSE
System.Security.Cryptography.SHA512Cng	FALSE
System.Security.Cryptography.SHA512CryptoServiceProvider	FALSE
System.Security.Cryptography.StrongNameSignatureInformation	FALSE
System.Security.Cryptography.SymmetricAlgorithm	FALSE
System.Security.Cryptography.TripleDES	FALSE
System.Security.Cryptography.TripleDESCng	FALSE
System.Security.Cryptography.Xml.CipherData	FALSE
System.Security.Cryptography.Xml.CipherReference	FALSE
System.Security.Cryptography.Xml.DataObject	FALSE
System.Security.Cryptography.Xml.DataReference	FALSE
System.Security.Cryptography.Xml.DSAKeyValue	FALSE
System.Security.Cryptography.Xml.EncryptedData	FALSE
System.Security.Cryptography.Xml.EncryptedKey	FALSE
System.Security.Cryptography.Xml.EncryptedReference	FALSE
System.Security.Cryptography.Xml.EncryptedType	FALSE
System.Security.Cryptography.Xml.EncryptedXml	FALSE
System.Security.Cryptography.Xml.EncryptionMethod	FALSE
System.Security.Cryptography.Xml.EncryptionProperty	FALSE
System.Security.Cryptography.Xml.EncryptionPropertyCollection	FALSE
System.Security.Cryptography.Xml.KeyInfo	FALSE
System.Security.Cryptography.Xml.KeyInfoClause	FALSE
System.Security.Cryptography.Xml.KeyInfoEncryptedKey	FALSE
System.Security.Cryptography.Xml.KeyInfoName	FALSE
System.Security.Cryptography.Xml.KeyInfoNode	FALSE
System.Security.Cryptography.Xml.KeyInfoRetrievalMethod	FALSE
System.Security.Cryptography.Xml.KeyInfoX509Data	FALSE
System.Security.Cryptography.Xml.KeyReference	FALSE
System.Security.Cryptography.Xml.Reference	FALSE
System.Security.Cryptography.Xml.ReferenceList	FALSE
System.Security.Cryptography.Xml.RSAKeyValue	FALSE
System.Security.Cryptography.Xml.Signature	FALSE
System.Security.Cryptography.Xml.SignedInfo	FALSE
System.Security.Cryptography.Xml.SignedXml	FALSE
System.Security.Cryptography.Xml.Transform	FALSE
System.Security.Cryptography.Xml.TransformChain	FALSE
System.Security.Cryptography.Xml.XmlDecryptionTransform	FALSE
System.Security.Cryptography.Xml.XmlDsigBase64Transform	FALSE
System.Security.Cryptography.Xml.XmlDsigC14NTransform	FALSE
System.Security.Cryptography.Xml.XmlDsigC14NWithCommentsTransform	FALSE
System.Security.Cryptography.Xml.XmlDsigEnvelopedSignatureTransform	FALSE
System.Security.Cryptography.Xml.XmlDsigExcC14NTransform	FALSE
System.Security.Cryptography.Xml.XmlDsigExcC14NWithCommentsTransform	FALSE
System.Security.Cryptography.Xml.XmlDsigXPathTransform	FALSE
System.Security.Cryptography.Xml.XmlDsigXsltTransform	FALSE
System.Security.Cryptography.Xml.XmlLicenseTransform	FALSE
System.Speech.AudioFormat.SpeechAudioFormatInfo	FALSE
System.Speech.Recognition.AudioLevelUpdatedEventArgs	FALSE
System.Speech.Recognition.AudioSignalProblemOccurredEventArgs	FALSE
System.Speech.Recognition.AudioStateChangedEventArgs	FALSE
System.Speech.Recognition.Choices	FALSE
System.Speech.Recognition.DictationGrammar	FALSE
System.Speech.Recognition.EmulateRecognizeCompletedEventArgs	FALSE
System.Speech.Recognition.Grammar	FALSE
System.Speech.Recognition.GrammarBuilder	FALSE
System.Speech.Recognition.LoadGrammarCompletedEventArgs	FALSE
System.Speech.Recognition.RecognitionEventArgs	FALSE
System.Speech.Recognition.RecognitionResult	FALSE
System.Speech.Recognition.RecognizeCompletedEventArgs	FALSE
System.Speech.Recognition.RecognizedAudio	FALSE
System.Speech.Recognition.RecognizedPhrase	FALSE
System.Speech.Recognition.RecognizedWordUnit	FALSE
System.Speech.Recognition.RecognizerInfo	FALSE
System.Speech.Recognition.RecognizerUpdateReachedEventArgs	FALSE
System.Speech.Recognition.ReplacementText	FALSE
System.Speech.Recognition.SemanticResultKey	FALSE
System.Speech.Recognition.SemanticResultValue	FALSE
System.Speech.Recognition.SemanticValue	FALSE
System.Speech.Recognition.SpeechDetectedEventArgs	FALSE
System.Speech.Recognition.SpeechHypothesizedEventArgs	FALSE
System.Speech.Recognition.SpeechRecognitionEngine	FALSE
System.Speech.Recognition.SpeechRecognitionRejectedEventArgs	FALSE
System.Speech.Recognition.SpeechRecognizedEventArgs	FALSE
System.Speech.Recognition.SpeechRecognizer	FALSE
System.Speech.Recognition.SpeechUI	FALSE
System.Speech.Recognition.StateChangedEventArgs	FALSE
System.Speech.Synthesis.BookmarkReachedEventArgs	FALSE
System.Speech.Synthesis.FilePrompt	FALSE
System.Speech.Synthesis.InstalledVoice	FALSE
System.Speech.Synthesis.PhonemeReachedEventArgs	FALSE
System.Speech.Synthesis.Prompt	FALSE
System.Speech.Synthesis.PromptBuilder	FALSE
System.Speech.Synthesis.PromptEventArgs	FALSE
System.Speech.Synthesis.PromptStyle	FALSE
System.Speech.Synthesis.SpeakCompletedEventArgs	FALSE
System.Speech.Synthesis.SpeakProgressEventArgs	FALSE
System.Speech.Synthesis.SpeakStartedEventArgs	FALSE
System.Speech.Synthesis.SpeechSynthesizer	FALSE
System.Speech.Synthesis.StateChangedEventArgs	FALSE
System.Speech.Synthesis.VisemeReachedEventArgs	FALSE
System.Speech.Synthesis.VoiceChangeEventArgs	FALSE
System.Speech.Synthesis.VoiceInfo	FALSE
System.Text.Decoder	FALSE
System.Text.DecoderExceptionFallback	FALSE
System.Text.DecoderExceptionFallbackBuffer	FALSE
System.Text.DecoderFallback	FALSE
System.Text.DecoderFallbackBuffer	FALSE
System.Text.DecoderFallbackException	FALSE
System.Text.DecoderReplacementFallback	FALSE
System.Text.DecoderReplacementFallbackBuffer	FALSE
System.Text.Encoder	FALSE
System.Text.EncoderExceptionFallback	FALSE
System.Text.EncoderExceptionFallbackBuffer	FALSE
System.Text.EncoderFallback	FALSE
System.Text.EncoderFallbackBuffer	FALSE
System.Text.EncoderFallbackException	FALSE
System.Text.EncoderReplacementFallback	FALSE
System.Text.EncoderReplacementFallbackBuffer	FALSE
System.Text.Encoding	FALSE
System.Text.EncodingInfo	FALSE
System.Text.EncodingProvider	FALSE
System.Text.UTF32Encoding	FALSE
System.Text.RegularExpressions.Capture	FALSE
System.Text.RegularExpressions.CaptureCollection	FALSE
System.Text.RegularExpressions.Group	FALSE
System.Text.RegularExpressions.GroupCollection	FALSE
System.Text.RegularExpressions.Match	FALSE
System.Text.RegularExpressions.MatchCollection	FALSE
System.Text.RegularExpressions.Regex	FALSE
System.Text.RegularExpressions.RegexCompilationInfo	FALSE
System.Text.RegularExpressions.RegexMatchTimeoutException	FALSE
System.Text.RegularExpressions.RegexRunner	FALSE
System.Text.RegularExpressions.RegexRunnerFactory	FALSE
System.Threading.AbandonedMutexException	FALSE
System.Threading.AsyncLocal	FALSE
System.Threading.AutoResetEvent	FALSE
System.Threading.Barrier	FALSE
System.Threading.BarrierPostPhaseException	FALSE
System.Threading.CancellationTokenSource	FALSE
System.Threading.CompressedStack	FALSE
System.Threading.CountdownEvent	FALSE
System.Threading.EventWaitHandle	FALSE
System.Threading.ExecutionContext	FALSE
System.Threading.HostExecutionContext	FALSE
System.Threading.HostExecutionContextManager	FALSE
System.Threading.Interlocked	FALSE
System.Threading.LazyInitializer	FALSE
System.Threading.LockRecursionException	FALSE
System.Threading.ManualResetEvent	FALSE
System.Threading.ManualResetEventSlim	FALSE
System.Threading.Monitor	FALSE
System.Threading.ReaderWriterLockSlim	FALSE
System.Threading.RegisteredWaitHandle	FALSE
System.Threading.Semaphore	FALSE
System.Threading.SemaphoreFullException	FALSE
System.Threading.SemaphoreSlim	FALSE
System.Threading.SynchronizationContext	FALSE
System.Threading.Thread	FALSE
System.Threading.ThreadAbortException	FALSE
System.Threading.ThreadExceptionEventArgs	FALSE
System.Threading.ThreadLocal	FALSE
System.Threading.ThreadPool	FALSE
System.Threading.ThreadStartException	FALSE
System.Threading.Timeout	FALSE
System.Threading.Timer	FALSE
System.Threading.Volatile	FALSE
System.Threading.WaitHandle	FALSE
System.Threading.WaitHandleCannotBeOpenedException	FALSE
System.Threading.WaitHandleExtensions	FALSE
System.Threading.Tasks.ConcurrentExclusiveSchedulerPair	FALSE
System.Threading.Tasks.Parallel	FALSE
System.Threading.Tasks.ParallelLoopState	FALSE
System.Threading.Tasks.ParallelOptions	FALSE
System.Threading.Tasks.Task	FALSE
System.Threading.Tasks.Task	FALSE
System.Threading.Tasks.TaskCanceledException	FALSE
System.Threading.Tasks.TaskCompletionSource	FALSE
System.Threading.Tasks.TaskExtensions	FALSE
System.Threading.Tasks.TaskFactory	FALSE
System.Threading.Tasks.TaskFactory	FALSE
System.Threading.Tasks.TaskScheduler	FALSE
System.Threading.Tasks.TaskSchedulerException	FALSE
System.Threading.Tasks.UnobservedTaskExceptionEventArgs	FALSE
System.Web.AspNetHostingPermission	FALSE
System.Web.AspNetHostingPermissionAttribute	FALSE
System.Web.DefaultHttpHandler	FALSE
System.Web.EventHandlerTaskAsyncHelper	FALSE
System.Web.HtmlString	FALSE
System.Web.HttpApplication	FALSE
System.Web.HttpApplicationState	FALSE
System.Web.HttpApplicationStateBase	FALSE
System.Web.HttpApplicationStateWrapper	FALSE
System.Web.HttpBrowserCapabilities	FALSE
System.Web.HttpBrowserCapabilitiesBase	FALSE
System.Web.HttpBrowserCapabilitiesWrapper	FALSE
System.Web.HttpCachePolicy	FALSE
System.Web.HttpCachePolicyBase	FALSE
System.Web.HttpCachePolicyWrapper	FALSE
System.Web.HttpCacheVaryByContentEncodings	FALSE
System.Web.HttpCacheVaryByHeaders	FALSE
System.Web.HttpCacheVaryByParams	FALSE
System.Web.HttpClientCertificate	FALSE
System.Web.HttpCompileException	FALSE
System.Web.HttpContext	FALSE
System.Web.HttpContextBase	FALSE
System.Web.HttpContextWrapper	FALSE
System.Web.HttpCookie	FALSE
System.Web.HttpCookieCollection	FALSE
System.Web.HttpException	FALSE
System.Web.HttpFileCollection	FALSE
System.Web.HttpFileCollectionBase	FALSE
System.Web.HttpFileCollectionWrapper	FALSE
System.Web.HttpModuleCollection	FALSE
System.Web.HttpParseException	FALSE
System.Web.HttpPostedFile	FALSE
System.Web.HttpPostedFileBase	FALSE
System.Web.HttpPostedFileWrapper	FALSE
System.Web.HttpRequest	FALSE
System.Web.HttpRequestBase	FALSE
System.Web.HttpRequestValidationException	FALSE
System.Web.HttpRequestWrapper	FALSE
System.Web.HttpResponse	FALSE
System.Web.HttpResponseBase	FALSE
System.Web.HttpResponseWrapper	FALSE
System.Web.HttpRuntime	FALSE
System.Web.HttpServerUtility	FALSE
System.Web.HttpServerUtilityBase	FALSE
System.Web.HttpServerUtilityWrapper	FALSE
System.Web.HttpSessionStateBase	FALSE
System.Web.HttpSessionStateWrapper	FALSE
System.Web.HttpStaticObjectsCollection	FALSE
System.Web.HttpStaticObjectsCollectionBase	FALSE
System.Web.HttpStaticObjectsCollectionWrapper	FALSE
System.Web.HttpTaskAsyncHandler	FALSE
System.Web.HttpUnhandledException	FALSE
System.Web.HttpUtility	FALSE
System.Web.HttpWorkerRequest	FALSE
System.Web.HttpWriter	FALSE
System.Web.IisTraceListener	FALSE
System.Web.MimeMapping	FALSE
System.Web.ParserError	FALSE
System.Web.ParserErrorCollection	FALSE
System.Web.PreApplicationStartMethodAttribute	FALSE
System.Web.ProcessInfo	FALSE
System.Web.ProcessModelInfo	FALSE
System.Web.SiteMap	FALSE
System.Web.SiteMapNode	FALSE
System.Web.SiteMapNodeCollection	FALSE
System.Web.SiteMapProvider	FALSE
System.Web.SiteMapProviderCollection	FALSE
System.Web.SiteMapResolveEventArgs	FALSE
System.Web.StaticSiteMapProvider	FALSE
System.Web.TraceContext	FALSE
System.Web.TraceContextEventArgs	FALSE
System.Web.TraceContextRecord	FALSE
System.Web.UnvalidatedRequestValues	FALSE
System.Web.UnvalidatedRequestValuesBase	FALSE
System.Web.UnvalidatedRequestValuesWrapper	FALSE
System.Web.VirtualPathUtility	FALSE
System.Web.WebPageTraceListener	FALSE
System.Web.XmlSiteMapProvider	FALSE
System.Windows.Application	FALSE
System.Windows.AttachedPropertyBrowsableAttribute	FALSE
System.Windows.AttachedPropertyBrowsableForChildrenAttribute	FALSE
System.Windows.AttachedPropertyBrowsableForTypeAttribute	FALSE
System.Windows.AttachedPropertyBrowsableWhenAttributePresentAttribute	FALSE
System.Windows.AutoResizedEventArgs	FALSE
System.Windows.BaseCompatibilityPreferences	FALSE
System.Windows.Clipboard	FALSE
System.Windows.ColorConvertedBitmapExtension	FALSE
System.Windows.ComponentResourceKey	FALSE
System.Windows.Condition	FALSE
System.Windows.ConditionCollection	FALSE
System.Windows.ContentElement	FALSE
System.Windows.ContentOperations	FALSE
System.Windows.CoreCompatibilityPreferences	FALSE
System.Windows.CornerRadiusConverter	FALSE
System.Windows.CultureInfoIetfLanguageTagConverter	FALSE
System.Windows.DataFormat	FALSE
System.Windows.DataFormats	FALSE
System.Windows.DataObject	FALSE
System.Windows.DataObjectCopyingEventArgs	FALSE
System.Windows.DataObjectEventArgs	FALSE
System.Windows.DataObjectPastingEventArgs	FALSE
System.Windows.DataObjectSettingDataEventArgs	FALSE
System.Windows.DataTemplate	FALSE
System.Windows.DataTemplateKey	FALSE
System.Windows.DataTrigger	FALSE
System.Windows.DeferrableContent	FALSE
System.Windows.DeferrableContentConverter	FALSE
System.Windows.DependencyObject	FALSE
System.Windows.DependencyObjectType	FALSE
System.Windows.DependencyProperty	FALSE
System.Windows.DependencyPropertyHelper	FALSE
System.Windows.DependencyPropertyKey	FALSE
System.Windows.DialogResultConverter	FALSE
System.Windows.DpiChangedEventArgs	FALSE
System.Windows.DragDrop	FALSE
System.Windows.DragEventArgs	FALSE
System.Windows.DurationConverter	FALSE
System.Windows.DynamicResourceExtension	FALSE
System.Windows.DynamicResourceExtensionConverter	FALSE
System.Windows.EventManager	FALSE
System.Windows.EventPrivateKey	FALSE
System.Windows.EventRoute	FALSE
System.Windows.EventSetter	FALSE
System.Windows.EventTrigger	FALSE
System.Windows.ExceptionRoutedEventArgs	FALSE
System.Windows.ExitEventArgs	FALSE
System.Windows.Expression	FALSE
System.Windows.ExpressionConverter	FALSE
System.Windows.FigureLengthConverter	FALSE
System.Windows.FontSizeConverter	FALSE
System.Windows.FontStretchConverter	FALSE
System.Windows.FontStretches	FALSE
System.Windows.FontStyleConverter	FALSE
System.Windows.FontStyles	FALSE
System.Windows.FontWeightConverter	FALSE
System.Windows.FontWeights	FALSE
System.Windows.FrameworkCompatibilityPreferences	FALSE
System.Windows.FrameworkContentElement	FALSE
System.Windows.FrameworkElement	FALSE
System.Windows.FrameworkElementFactory	FALSE
System.Windows.FrameworkPropertyMetadata	FALSE
System.Windows.FrameworkTemplate	FALSE
System.Windows.Freezable	FALSE
System.Windows.FreezableCollection	FALSE
System.Windows.GiveFeedbackEventArgs	FALSE
System.Windows.GridLengthConverter	FALSE
System.Windows.HierarchicalDataTemplate	FALSE
System.Windows.HwndDpiChangedEventArgs	FALSE
System.Windows.Int32RectConverter	FALSE
System.Windows.KeySplineConverter	FALSE
System.Windows.KeyTimeConverter	FALSE
System.Windows.LengthConverter	FALSE
System.Windows.WeakEventManager.ListenerList	FALSE
System.Windows.WeakEventManager.ListenerList	FALSE
System.Windows.LocalizabilityAttribute	FALSE
System.Windows.Localization	FALSE
System.Windows.LogicalTreeHelper	FALSE
System.Windows.LostFocusEventManager	FALSE
System.Windows.MediaScriptCommandRoutedEventArgs	FALSE
System.Windows.MessageBox	FALSE
System.Windows.MultiDataTrigger	FALSE
System.Windows.MultiTrigger	FALSE
System.Windows.NameScope	FALSE
System.Windows.NullableBoolConverter	FALSE
System.Windows.PointConverter	FALSE
System.Windows.PresentationSource	FALSE
System.Windows.PropertyMetadata	FALSE
System.Windows.PropertyPath	FALSE
System.Windows.PropertyPathConverter	FALSE
System.Windows.QueryContinueDragEventArgs	FALSE
System.Windows.RectConverter	FALSE
System.Windows.RequestBringIntoViewEventArgs	FALSE
System.Windows.ResourceDictionary	FALSE
System.Windows.ResourceKey	FALSE
System.Windows.ResourceReferenceKeyNotFoundException	FALSE
System.Windows.RoutedEvent	FALSE
System.Windows.RoutedEventArgs	FALSE
System.Windows.RoutedPropertyChangedEventArgs	FALSE
System.Windows.SessionEndingCancelEventArgs	FALSE
System.Windows.Setter	FALSE
System.Windows.SetterBase	FALSE
System.Windows.SetterBaseCollection	FALSE
System.Windows.SizeChangedEventArgs	FALSE
System.Windows.SizeChangedInfo	FALSE
System.Windows.SizeConverter	FALSE
System.Windows.SourceChangedEventArgs	FALSE
System.Windows.SplashScreen	FALSE
System.Windows.StartupEventArgs	FALSE
System.Windows.StaticResourceExtension	FALSE
System.Windows.StrokeCollectionConverter	FALSE
System.Windows.Style	FALSE
System.Windows.StyleTypedPropertyAttribute	FALSE
System.Windows.SystemColors	FALSE
System.Windows.SystemCommands	FALSE
System.Windows.SystemFonts	FALSE
System.Windows.SystemParameters	FALSE
System.Windows.TemplateBindingExpression	FALSE
System.Windows.TemplateBindingExpressionConverter	FALSE
System.Windows.TemplateBindingExtension	FALSE
System.Windows.TemplateBindingExtensionConverter	FALSE
System.Windows.TemplateContent	FALSE
System.Windows.TemplateContentLoader	FALSE
System.Windows.TemplateKey	FALSE
System.Windows.TemplatePartAttribute	FALSE
System.Windows.TemplateVisualStateAttribute	FALSE
System.Windows.TextDecoration	FALSE
System.Windows.TextDecorationCollection	FALSE
System.Windows.TextDecorationCollectionConverter	FALSE
System.Windows.TextDecorations	FALSE
System.Windows.ThemeDictionaryExtension	FALSE
System.Windows.ThemeInfoAttribute	FALSE
System.Windows.ThicknessConverter	FALSE
System.Windows.Trigger	FALSE
System.Windows.TriggerAction	FALSE
System.Windows.TriggerActionCollection	FALSE
System.Windows.TriggerBase	FALSE
System.Windows.TriggerCollection	FALSE
System.Windows.UIElement	FALSE
System.Windows.UIElement3D	FALSE
System.Windows.UIPropertyMetadata	FALSE
System.Windows.VectorConverter	FALSE
System.Windows.VisualState	FALSE
System.Windows.VisualStateChangedEventArgs	FALSE
System.Windows.VisualStateGroup	FALSE
System.Windows.VisualStateManager	FALSE
System.Windows.VisualTransition	FALSE
System.Windows.WeakEventManager	FALSE
System.Windows.WeakEventManager	FALSE
System.Windows.Window	FALSE
System.Windows.WindowCollection	FALSE
System.Workflow.Activities.Rules.AddedConditionAction	FALSE
System.Workflow.Activities.Rules.AddedRuleSetAction	FALSE
System.Workflow.Activities.Rules.RemovedConditionAction	FALSE
System.Workflow.Activities.Rules.RemovedRuleSetAction	FALSE
System.Workflow.Activities.Rules.Rule	FALSE
System.Workflow.Activities.Rules.RuleAction	FALSE
System.Workflow.Activities.Rules.RuleActionTrackingEvent	FALSE
System.Workflow.Activities.Rules.RuleAnalysis	FALSE
System.Workflow.Activities.Rules.RuleAttribute	FALSE
System.Workflow.Activities.Rules.RuleCondition	FALSE
System.Workflow.Activities.Rules.RuleConditionChangeAction	FALSE
System.Workflow.Activities.Rules.RuleConditionCollection	FALSE
System.Workflow.Activities.Rules.RuleConditionReference	FALSE
System.Workflow.Activities.Rules.RuleDefinitions	FALSE
System.Workflow.Activities.Rules.RuleEngine	FALSE
System.Workflow.Activities.Rules.RuleEvaluationException	FALSE
System.Workflow.Activities.Rules.RuleEvaluationIncompatibleTypesException	FALSE
System.Workflow.Activities.Rules.RuleException	FALSE
System.Workflow.Activities.Rules.RuleExecution	FALSE
System.Workflow.Activities.Rules.RuleExpressionCondition	FALSE
System.Workflow.Activities.Rules.RuleExpressionInfo	FALSE
System.Workflow.Activities.Rules.RuleExpressionResult	FALSE
System.Workflow.Activities.Rules.RuleExpressionWalker	FALSE
System.Workflow.Activities.Rules.RuleHaltAction	FALSE
System.Workflow.Activities.Rules.RuleInvokeAttribute	FALSE
System.Workflow.Activities.Rules.RuleLiteralResult	FALSE
System.Workflow.Activities.Rules.RulePathQualifier	FALSE
System.Workflow.Activities.Rules.RuleReadAttribute	FALSE
System.Workflow.Activities.Rules.RuleReadWriteAttribute	FALSE
System.Workflow.Activities.Rules.RuleSet	FALSE
System.Workflow.Activities.Rules.RuleSetChangeAction	FALSE
System.Workflow.Activities.Rules.RuleSetCollection	FALSE
System.Workflow.Activities.Rules.RuleSetReference	FALSE
System.Workflow.Activities.Rules.RuleSetValidationException	FALSE
System.Workflow.Activities.Rules.RuleStatementAction	FALSE
System.Workflow.Activities.Rules.RuleUpdateAction	FALSE
System.Workflow.Activities.Rules.RuleValidation	FALSE
System.Workflow.Activities.Rules.RuleWriteAttribute	FALSE
System.Workflow.Activities.Rules.UpdatedConditionAction	FALSE
System.Workflow.Activities.Rules.UpdatedRuleSetAction	FALSE
System.Xml.NameTable	FALSE
System.Xml.UniqueId	FALSE
System.Xml.XmlAttribute	FALSE
System.Xml.XmlAttributeCollection	FALSE
System.Xml.XmlBinaryReaderSession	FALSE
System.Xml.XmlBinaryWriterSession	FALSE
System.Xml.XmlCDataSection	FALSE
System.Xml.XmlCharacterData	FALSE
System.Xml.XmlComment	FALSE
System.Xml.XmlConvert	FALSE
System.Xml.XmlDataDocument	FALSE
System.Xml.XmlDeclaration	FALSE
System.Xml.XmlDictionary	FALSE
System.Xml.XmlDictionaryReader	FALSE
System.Xml.XmlDictionaryReaderQuotas	FALSE
System.Xml.XmlDictionaryString	FALSE
System.Xml.XmlDictionaryWriter	FALSE
System.Xml.XmlDocument	FALSE
System.Xml.XmlDocumentFragment	FALSE
System.Xml.XmlDocumentType	FALSE
System.Xml.XmlElement	FALSE
System.Xml.XmlEntity	FALSE
System.Xml.XmlEntityReference	FALSE
System.Xml.XmlException	FALSE
System.Xml.XmlImplementation	FALSE
System.Xml.XmlLinkedNode	FALSE
System.Xml.XmlNamedNodeMap	FALSE
System.Xml.XmlNamespaceManager	FALSE
System.Xml.XmlNameTable	FALSE
System.Xml.XmlNode	FALSE
System.Xml.XmlNodeChangedEventArgs	FALSE
System.Xml.XmlNodeList	FALSE
System.Xml.XmlNodeReader	FALSE
System.Xml.XmlNotation	FALSE
System.Xml.XmlParserContext	FALSE
System.Xml.XmlProcessingInstruction	FALSE
System.Xml.XmlQualifiedName	FALSE
System.Xml.XmlReader	FALSE
System.Xml.XmlReaderSettings	FALSE
System.Xml.XmlResolver	FALSE
System.Xml.XmlSecureResolver	FALSE
System.Xml.XmlSignificantWhitespace	FALSE
System.Xml.XmlText	FALSE
System.Xml.XmlTextReader	FALSE
System.Xml.XmlTextWriter	FALSE
System.Xml.XmlUrlResolver	FALSE
System.Xml.XmlValidatingReader	FALSE
System.Xml.XmlWhitespace	FALSE
System.Xml.XmlWriter	FALSE
System.Xml.XmlWriterSettings	FALSE
System.Xml.XmlXapResolver	FALSE
Microsoft.Build.BuildEngine.BuildItem	FALSE
Microsoft.Build.BuildEngine.BuildItemGroup	FALSE
Microsoft.Build.BuildEngine.BuildItemGroupCollection	FALSE
Microsoft.Build.BuildEngine.BuildProperty	FALSE
Microsoft.Build.BuildEngine.BuildPropertyGroup	FALSE
Microsoft.Build.BuildEngine.BuildPropertyGroupCollection	FALSE
Microsoft.Build.BuildEngine.BuildTask	FALSE
Microsoft.Build.BuildEngine.ConfigurableForwardingLogger	FALSE
Microsoft.Build.BuildEngine.ConsoleLogger	FALSE
Microsoft.Build.BuildEngine.DistributedFileLogger	FALSE
Microsoft.Build.BuildEngine.Engine	FALSE
Microsoft.Build.BuildEngine.FileLogger	FALSE
Microsoft.Build.BuildEngine.Import	FALSE
Microsoft.Build.BuildEngine.ImportCollection	FALSE
Microsoft.Build.BuildEngine.InternalLoggerException	FALSE
Microsoft.Build.BuildEngine.InvalidProjectFileException	FALSE
Microsoft.Build.BuildEngine.InvalidToolsetDefinitionException	FALSE
Microsoft.Build.BuildEngine.LocalNode	FALSE
Microsoft.Build.BuildEngine.LoggerDescription	FALSE
Microsoft.Build.BuildEngine.Project	FALSE
Microsoft.Build.BuildEngine.RemoteErrorException	FALSE
Microsoft.Build.BuildEngine.SolutionWrapperProject	FALSE
Microsoft.Build.BuildEngine.Target	FALSE
Microsoft.Build.BuildEngine.TargetCollection	FALSE
Microsoft.Build.BuildEngine.Toolset	FALSE
Microsoft.Build.BuildEngine.ToolsetCollection	FALSE
Microsoft.Build.BuildEngine.UsingTask	FALSE
Microsoft.Build.BuildEngine.UsingTaskCollection	FALSE
Microsoft.Build.BuildEngine.Utilities	FALSE
Microsoft.Win32.CommonDialog	FALSE
Microsoft.Win34.FileDialog	FALSE
Microsoft.Win36.FileDialogCustomPlace	FALSE
Microsoft.Win38.FileDialogCustomPlaces	FALSE
Microsoft.Win40.IntranetZoneCredentialPolicy	FALSE
Microsoft.Win42.OpenFileDialog	FALSE
Microsoft.Win44.PowerModeChangedEventArgs	FALSE
Microsoft.Win46.Registry	FALSE
Microsoft.Win48.RegistryKey	FALSE
Microsoft.Win50.SaveFileDialog	FALSE
Microsoft.Win52.SessionEndedEventArgs	FALSE
Microsoft.Win54.SessionEndingEventArgs	FALSE
Microsoft.Win56.SessionSwitchEventArgs	FALSE
Microsoft.Win58.SystemEvents	FALSE
Microsoft.Win60.TimerElapsedEventArgs	FALSE
Microsoft.Win62.UserPreferenceChangedEventArgs	FALSE
Microsoft.Win64.UserPreferenceChangingEventArgs	FALSE
Microsoft.JScript.ActivationObject	FALSE
Microsoft.JScript.ActiveXObjectConstructor	FALSE
Microsoft.JScript.ArgumentsObject	FALSE
Microsoft.JScript.ArrayConstructor	FALSE
Microsoft.JScript.ArrayLiteral	FALSE
Microsoft.JScript.ArrayObject	FALSE
Microsoft.JScript.ArrayPrototype	FALSE
Microsoft.JScript.ArrayWrapper	FALSE
Microsoft.JScript.AssemblyCustomAttributeList	FALSE
Microsoft.JScript.AST	FALSE
Microsoft.JScript.ASTList	FALSE
Microsoft.JScript.BinaryOp	FALSE
Microsoft.JScript.Binding	FALSE
Microsoft.JScript.BitwiseBinary	FALSE
Microsoft.JScript.Block	FALSE
Microsoft.JScript.BlockScope	FALSE
Microsoft.JScript.BooleanConstructor	FALSE
Microsoft.JScript.BooleanObject	FALSE
Microsoft.JScript.BooleanPrototype	FALSE
Microsoft.JScript.BreakOutOfFinally	FALSE
Microsoft.JScript.Closure	FALSE
Microsoft.JScript.CmdLineException	FALSE
Microsoft.JScript.CmdLineOptionParser	FALSE
Microsoft.JScript.COMCharStream	FALSE
Microsoft.JScript.Context	FALSE
Microsoft.JScript.ContinueOutOfFinally	FALSE
Microsoft.JScript.Convert	FALSE
Microsoft.JScript.DateConstructor	FALSE
Microsoft.JScript.DateObject	FALSE
Microsoft.JScript.DatePrototype	FALSE
Microsoft.JScript.DebugBreak	FALSE
Microsoft.JScript.DocumentContext	FALSE
Microsoft.JScript.DynamicFieldInfo	FALSE
Microsoft.JScript.Empty	FALSE
Microsoft.JScript.EndOfFile	FALSE
Microsoft.JScript.EnumeratorConstructor	FALSE
Microsoft.JScript.EnumeratorObject	FALSE
Microsoft.JScript.EnumeratorPrototype	FALSE
Microsoft.JScript.Equality	FALSE
Microsoft.JScript.ErrorConstructor	FALSE
Microsoft.JScript.ErrorObject	FALSE
Microsoft.JScript.ErrorPrototype	FALSE
Microsoft.JScript.Eval	FALSE
Microsoft.JScript.EvalErrorObject	FALSE
Microsoft.JScript.Expando	FALSE
Microsoft.JScript.FieldAccessor	FALSE
Microsoft.JScript.ForIn	FALSE
Microsoft.JScript.FunctionConstructor	FALSE
Microsoft.JScript.FunctionDeclaration	FALSE
Microsoft.JScript.FunctionExpression	FALSE
Microsoft.JScript.FunctionObject	FALSE
Microsoft.JScript.FunctionPrototype	FALSE
Microsoft.JScript.FunctionWrapper	FALSE
Microsoft.JScript.GlobalObject	FALSE
Microsoft.JScript.Globals	FALSE
Microsoft.JScript.GlobalScope	FALSE
Microsoft.JScript.Hide	FALSE
Microsoft.JScript.Import	FALSE
Microsoft.JScript.In	FALSE
Microsoft.JScript.Instanceof	FALSE
Microsoft.JScript.JSConstructor	FALSE
Microsoft.JScript.JScriptCodeProvider	FALSE
Microsoft.JScript.JScriptException	FALSE
Microsoft.JScript.JSField	FALSE
Microsoft.JScript.JSFieldInfo	FALSE
Microsoft.JScript.JSFunctionAttribute	FALSE
Microsoft.JScript.JSLocalField	FALSE
Microsoft.JScript.JSMethod	FALSE
Microsoft.JScript.JSMethodInfo	FALSE
Microsoft.JScript.JSObject	FALSE
Microsoft.JScript.JSParser	FALSE
Microsoft.JScript.JSPrototypeObject	FALSE
Microsoft.JScript.JSScanner	FALSE
Microsoft.JScript.JSVariableField	FALSE
Microsoft.JScript.LateBinding	FALSE
Microsoft.JScript.LenientArrayPrototype	FALSE
Microsoft.JScript.LenientBooleanPrototype	FALSE
Microsoft.JScript.LenientDateConstructor	FALSE
Microsoft.JScript.LenientDatePrototype	FALSE
Microsoft.JScript.LenientEnumeratorPrototype	FALSE
Microsoft.JScript.LenientErrorPrototype	FALSE
Microsoft.JScript.LenientFunctionPrototype	FALSE
Microsoft.JScript.LenientGlobalObject	FALSE
Microsoft.JScript.LenientMathObject	FALSE
Microsoft.JScript.LenientNumberPrototype	FALSE
Microsoft.JScript.LenientObjectPrototype	FALSE
Microsoft.JScript.LenientRegExpPrototype	FALSE
Microsoft.JScript.LenientStringConstructor	FALSE
Microsoft.JScript.LenientStringPrototype	FALSE
Microsoft.JScript.LenientVBArrayPrototype	FALSE
Microsoft.JScript.MathObject	FALSE
Microsoft.JScript.MemberInfoList	FALSE
Microsoft.JScript.MethodInvoker	FALSE
Microsoft.JScript.Missing	FALSE
Microsoft.JScript.Namespace	FALSE
Microsoft.JScript.NoContextException	FALSE
Microsoft.JScript.NotRecommended	FALSE
Microsoft.JScript.NumberConstructor	FALSE
Microsoft.JScript.NumberObject	FALSE
Microsoft.JScript.NumberPrototype	FALSE
Microsoft.JScript.NumericBinary	FALSE
Microsoft.JScript.NumericUnary	FALSE
Microsoft.JScript.ObjectConstructor	FALSE
Microsoft.JScript.ObjectPrototype	FALSE
Microsoft.JScript.Override	FALSE
Microsoft.JScript.Package	FALSE
Microsoft.JScript.ParserException	FALSE
Microsoft.JScript.Plus	FALSE
Microsoft.JScript.PostOrPrefixOperator	FALSE
Microsoft.JScript.RangeErrorObject	FALSE
Microsoft.JScript.ReferenceAttribute	FALSE
Microsoft.JScript.ReferenceErrorObject	FALSE
Microsoft.JScript.RegExpConstructor	FALSE
Microsoft.JScript.RegExpMatch	FALSE
Microsoft.JScript.RegExpObject	FALSE
Microsoft.JScript.RegExpPrototype	FALSE
Microsoft.JScript.Relational	FALSE
Microsoft.JScript.ReturnOutOfFinally	FALSE
Microsoft.JScript.Runtime	FALSE
Microsoft.JScript.ScriptBlock	FALSE
Microsoft.JScript.ScriptFunction	FALSE
Microsoft.JScript.ScriptObject	FALSE
Microsoft.JScript.ScriptStream	FALSE
Microsoft.JScript.SimpleHashtable	FALSE
Microsoft.JScript.StackFrame	FALSE
Microsoft.JScript.StrictEquality	FALSE
Microsoft.JScript.StringConstructor	FALSE
Microsoft.JScript.StringObject	FALSE
Microsoft.JScript.StringPrototype	FALSE
Microsoft.JScript.SuperTypeMembersSorter	FALSE
Microsoft.JScript.SyntaxErrorObject	FALSE
Microsoft.JScript.Throw	FALSE
Microsoft.JScript.Try	FALSE
Microsoft.JScript.TypedArray	FALSE
Microsoft.JScript.TypeErrorObject	FALSE
Microsoft.JScript.Typeof	FALSE
Microsoft.JScript.TypeReflector	FALSE
Microsoft.JScript.UnaryOp	FALSE
Microsoft.JScript.URIErrorObject	FALSE
Microsoft.JScript.VBArrayConstructor	FALSE
Microsoft.JScript.VBArrayObject	FALSE
Microsoft.JScript.VBArrayPrototype	FALSE
Microsoft.JScript.VsaItem	FALSE
Microsoft.JScript.VsaItems	FALSE
Microsoft.JScript.With	FALSE
Microsoft.CSharp.CSharpCodeProvider	FALSE
Microsoft.VisualC.DebugInfoInPDBAttribute	FALSE
Microsoft.VisualC.DecoratedNameAttribute	FALSE
Microsoft.VisualC.IsConstModifier	FALSE
Microsoft.VisualC.IsCXXReferenceModifier	FALSE
Microsoft.VisualC.IsLongModifier	FALSE
Microsoft.VisualC.IsSignedModifier	FALSE
Microsoft.VisualC.IsVolatileModifier	FALSE
Microsoft.VisualC.MiscellaneousBitsAttribute	FALSE
Microsoft.VisualC.NeedsCopyConstructorModifier	FALSE
Microsoft.VisualC.NoSignSpecifiedModifier	FALSE
